Уровень №1. FML
4,70
0:00 0:00 1:03 1:03 1:03 0:00 0:00 0:00 1:04 0:00 0:00 0:00 1:04 0:00 0:00 0:00 1:05 1:05
0:00 1:03 0:00 1:03 0:00 1:03 0:00 0:00 1:04 1:04 0:00 1:04 1:04 0:00 0:00 1:05 0:00 1:05
1:03 0:00 0:00 1:03 0:00 0:00 1:03 0:00 1:04 1:04 0:00 1:04 1:04 0:00 0:00 1:05 0:00 1:05
1:03 0:00 0:00 1:03 0:00 0:00 1:03 0:00 1:04 1:04 0:00 1:04 1:04 0:00 0:00 1:05 0:00 1:05
1:03 0:00 0:00 1:03 0:00 0:00 1:03 0:00 1:04 0:00 1:04 0:00 1:04 0:00 1:05 0:00 0:00 1:05
1:03 0:00 0:00 1:03 0:00 0:00 1:03 0:00 1:04 0:00 1:04 0:00 1:04 0:00 1:05 0:00 0:00 1:05
0:00 1:03 0:00 1:03 0:00 1:03 0:00 0:00 1:04 0:00 0:00 0:00 1:04 0:00 1:05 0:00 0:00 1:05
0:00 0:00 1:03 1:03 1:03 0:00 0:00 0:00 1:04 0:00 0:00 0:00 1:04 0:00 1:05 0:00 0:00 1:05
0:00 0:00 0:00 0:00 0:00 0:00 0:00 0:00 0:00 0:00 0:00 0:00 0:00 0:00 0:00 0:00 0:00 0:00
1:01 1:02 1:05 1:02 1:05 1:01 1:01 1:05 1:05 1:02 1:01 1:02 1:05 1:02 1:02 1:05 1:01 1:01
1:01 1:02 1:05 1:02 1:05 1:01 1:01 1:05 1:05 1:02 1:01 1:02 1:05 1:02 1:02 1:05 1:01 1:01
